//MAP CONVERTED BY dmm2tgm.py THIS HEADER COMMENT PREVENTS RECONVERSION, DO NOT REMOVE
"a" = (
/turf/open/space/basic,
/area/space)
"c" = (
/obj/structure/window/reinforced{
	dir = 8
	},
/obj/structure/window/reinforced{
	dir = 1
	},
/turf/open/floor/plasteel,
/area/ruin/powered)
"e" = (
/obj/machinery/conveyor/auto,
/turf/open/floor/plasteel,
/area/ruin/powered)
"f" = (
/obj/structure/holobox,
/turf/open/floor/plasteel,
/area/ruin/powered)
"j" = (
/turf/open/floor/plastic,
/area/ruin/powered)
"k" = (
/obj/machinery/conveyor/auto{
	dir = 8
	},
/turf/open/floor/plasteel,
/area/ruin/powered)
"l" = (
/obj/machinery/conveyor/auto,
/obj/structure/window/reinforced{
	dir = 1
	},
/turf/open/floor/plasteel,
/area/ruin/powered)
"m" = (
/obj/machinery/conveyor/auto{
	dir = 8
	},
/obj/structure/window/reinforced{
	dir = 4
	},
/obj/structure/window/reinforced{
	dir = 1
	},
/turf/open/floor/plasteel,
/area/ruin/powered)
"n" = (
/obj/machinery/conveyor/auto{
	dir = 1
	},
/obj/structure/window/reinforced{
	dir = 4
	},
/turf/open/floor/plasteel,
/area/ruin/powered)
"q" = (
/turf/open/floor/plasteel,
/area/ruin/powered)
"t" = (
/obj/machinery/conveyor/auto{
	dir = 4
	},
/turf/open/floor/plasteel,
/area/ruin/powered)
"v" = (
/obj/structure/closet/crate,
/turf/open/floor/plasteel,
/area/ruin/powered)
"x" = (
/turf/closed/wall/r_wall/rust,
/area/ruin/powered)
"z" = (
/obj/structure/window/reinforced{
	dir = 4
	},
/obj/structure/window/reinforced{
	dir = 1
	},
/turf/open/floor/plasteel,
/area/ruin/powered)
"F" = (
/turf/closed/indestructible/reinforced,
/area/ruin/powered)
"G" = (
/obj/structure/holobox,
/turf/open/floor/plating,
/area/ruin/powered)
"H" = (
/obj/structure/window/reinforced{
	dir = 1
	},
/turf/open/floor/plasteel,
/area/ruin/powered)
"I" = (
/obj/structure/closet/crate,
/turf/open/floor/plating,
/area/ruin/powered)
"L" = (
/obj/structure/window/reinforced{
	dir = 4
	},
/turf/open/floor/plasteel,
/area/ruin/powered)
"M" = (
/turf/closed/wall,
/area/ruin/powered)
"N" = (
/obj/structure/plasticflaps,
/turf/open/floor/plasteel,
/area/ruin/powered)
"O" = (
/turf/open/floor/plating,
/area/ruin/powered)
"P" = (
/obj/machinery/conveyor/auto{
	dir = 8
	},
/obj/structure/window/reinforced{
	dir = 1
	},
/turf/open/floor/plasteel,
/area/ruin/powered)
"Q" = (
/turf/open/floor/plating{
	broken = 1;
	icon_state = "platingdmg1"
	},
/area/ruin/powered)
"R" = (
/obj/structure/holobox,
/turf/open/floor/plastic,
/area/ruin/powered)
"S" = (
/obj/structure/window/reinforced/fulltile,
/obj/structure/grille,
/turf/open/floor/plating,
/area/ruin/powered)
"W" = (
/turf/closed/wall/r_wall,
/area/ruin/powered)
"X" = (
/obj/structure/window/reinforced,
/turf/open/floor/plasteel,
/area/ruin/powered)
"Z" = (
/obj/structure/window/reinforced{
	dir = 8
	},
/obj/structure/window/reinforced,
/turf/open/floor/plasteel,
/area/ruin/powered)

(1,1,1) = {"
a
a
a
a
a
a
a
a
a
a
a
a
a
a
a
a
a
a
a
a
"}
(2,1,1) = {"
a
a
a
a
a
a
a
a
a
a
a
a
a
a
a
a
a
a
a
a
"}
(3,1,1) = {"
a
a
x
x
x
x
x
x
x
x
x
x
x
x
x
x
x
x
a
a
"}
(4,1,1) = {"
a
a
x
O
O
O
x
O
q
O
O
O
O
O
O
q
O
W
a
a
"}
(5,1,1) = {"
a
a
x
O
x
x
x
O
O
O
M
M
M
q
q
O
q
q
a
a
"}
(6,1,1) = {"
a
a
x
O
O
O
x
O
O
O
M
G
M
q
q
O
O
q
a
a
"}
(7,1,1) = {"
a
a
x
O
O
O
x
O
O
O
v
O
I
O
O
O
O
O
a
a
"}
(8,1,1) = {"
a
a
x
O
O
O
x
x
q
x
x
x
x
x
O
q
O
x
a
a
"}
(9,1,1) = {"
a
a
x
O
O
O
O
O
O
O
x
f
O
x
O
q
O
x
a
a
"}
(10,1,1) = {"
a
a
x
O
O
O
O
O
O
O
x
O
q
O
O
q
O
x
a
a
"}
(11,1,1) = {"
a
a
x
x
x
x
q
q
q
q
x
x
x
x
x
x
x
x
a
a
"}
(12,1,1) = {"
a
a
x
q
q
q
q
q
q
O
q
l
e
e
t
x
a
a
a
a
"}
(13,1,1) = {"
a
a
x
q
O
q
q
q
O
x
O
P
c
Z
t
x
a
a
a
a
"}
(14,1,1) = {"
a
a
x
q
q
O
O
O
q
O
q
P
H
X
t
x
a
a
a
a
"}
(15,1,1) = {"
a
a
x
q
q
O
O
O
q
q
q
k
H
X
t
x
a
a
a
a
"}
(16,1,1) = {"
a
a
x
q
q
O
O
O
q
q
q
P
H
X
t
x
a
a
a
a
"}
(17,1,1) = {"
a
a
x
q
q
q
q
q
q
O
q
P
z
L
t
x
a
a
a
a
"}
(18,1,1) = {"
a
a
x
x
x
x
q
O
O
x
O
m
n
n
n
x
a
a
a
a
"}
(19,1,1) = {"
a
a
a
a
a
x
q
q
O
O
q
q
q
O
q
x
a
a
a
a
"}
(20,1,1) = {"
a
a
a
a
a
x
q
O
q
O
O
O
O
q
q
x
a
a
a
a
"}
(21,1,1) = {"
a
a
a
a
a
x
Q
q
O
O
O
q
q
O
q
x
a
a
a
a
"}
(22,1,1) = {"
a
a
a
a
a
x
q
O
O
q
O
q
O
q
q
x
a
a
a
a
"}
(23,1,1) = {"
a
a
a
a
a
F
N
S
S
N
F
F
q
F
F
F
F
F
a
a
"}
(24,1,1) = {"
a
a
a
a
a
F
j
j
j
j
F
q
q
q
q
q
q
F
a
a
"}
(25,1,1) = {"
a
a
a
a
a
F
j
j
j
j
F
q
q
q
q
q
q
F
a
a
"}
(26,1,1) = {"
a
a
a
a
a
F
j
j
j
j
F
q
q
q
q
q
q
F
a
a
"}
(27,1,1) = {"
a
a
a
a
a
F
j
R
j
j
F
q
q
q
q
q
q
F
a
a
"}
(28,1,1) = {"
a
a
a
a
a
F
F
F
F
F
F
F
F
F
F
F
F
F
a
a
"}
(29,1,1) = {"
a
a
a
a
a
a
a
a
a
a
a
a
a
a
a
a
a
a
a
a
"}
(30,1,1) = {"
a
a
a
a
a
a
a
a
a
a
a
a
a
a
a
a
a
a
a
a
"}
